%%%%%%%%%%%%%%%%%%%%
%.    .      .    .%
%.%%.%.%%%%%%.%.%%.%
%......      ......%
% %%%%%%%  %%%%%%% %
%.    .      .    .%
%.%%.%.%%%%%%.%.%%.%
%......      ......%
% %%%%%%%%%%%%%%%% %
%      13%%24      %
%%%%%%%%%%%%%%%%%%%%