%%%%%%%%%%%%
%        42%
%      %%%%%
%%%%%      %
%13 .   .  %
%%%%%%%%%%%%