%%%%%%%%%%%%%%%%%%%%
%.    .      .    .%
%.%%.%.%%%%%%.%.%%.%
%......      ......%
% %%%%%%%%%%%%%%%% %
%     13  %% 42    %
%%%%%%%%%%%%%%%%%%%%
